size = 50
numRows = 10
numCols = 20
numBlocker = 5
numMons = 3
####################
#   N    M      B  #
#     @      @     #
# M      B         #
#     @     @      #
#   @   M       @  #
#            P     #
#  B  @          B #
# @       B  @     #
####################