size = 50
numRows = 10
numCols = 20
numBlocker = 3
numMons = 1
####################
#      B @         #
#  M    @ @        #
#      @   @       #
#    @  P    @   B #
#  @     N     @   #
#    @   @  @      #
#   @  @  @  @     #
#    @      @    B #
####################