size = 50
numRows = 10
numCols = 20
numBlocker = 4
numMons = 2
####################
#         M        #
#  B    @ @     B  #
#      @   @       #
#    @  P  B @     #
#     @  @  @      #
#    @   N  @   M  #
#   @  @  @  @     #
#           B      #
####################